21 47
11 12 12 12 12 12 12 12 12 12 12 12 12 12 12 12 12 12 12 12 12 12 12 12 12 12 12 12 12 12 12 12 12 12 12 12 12 12 12 12 12 12 12 12 12 12 13
14 18 18 18 18 18 18 18 18 18 18 18 18 18 18 18 18 18 18 18 18 18 18 18 18 18 18 18 18 18 18 18 18 18 18 18 18 18 18 18 18 18 18 18 18 18 16
14 0  0  0  0  0  0  0  0  0  0  0  0  0  0  0  0  0  0  0  0  0  0  0  0  0  0  0  0  0  0  0  0  0  0  0  0  0  0  0  0  0  0  0  0  40 16
14 72 0  0  0  0  0  0  0  0  0  0  0  0  0  0  39 0  0  0  0  30 0  29 0  0  0  0  0  0  0  0  0  0  0  0  0  0  0  0  0  0  0  0  1  2  16
14 2  2  3  0  43 0  0  0  0  0  0  0  0  0  0  0  0  0  0  0  0  0  0  0  0  0  0  0  0  0  0  0  0  0  39 0  0  0  0  0  0  21 0  35 37 16
14 9  9  9  2  2  3  0  0  0  0  0  0  0  0  0  21 0  0  0  0  0  0  0  0  0  0  0  0  0  0  0  0  0  0  21 0  0  0  0  0  31 0  0  0  0  16
14 9  9  9  9  9  38 0  42 73 28 0  0  0  0  0  0  0  0  0  32 0  0  0  0  0  0  0  0  0  0  0  0  0  0  0  0  42 0  0  4  6  0  0  0  0  16
14 2  2  2  2  2  2  2  2  2  2  2  2  7  7  7  7  7  7  7  2  2  2  2  2  2  3  0  0  0  4  6  0  0  0  0  0  27 0  0  0  0  0  0  0  0  16
14 9  9  9  9  9  9  9  9  9  9  9  9  10 10 10 10 10 10 10 9  9  9  9  9  9  38 0  0  0  0  29 0  0  0  0  4  5  6  0  0  0  0  0  0  0  16
14 37 37 37 37 37 37 37 37 37 37 37 37 37 37 37 37 37 37 37 37 37 37 37 37 37 36 0  0  0  0  0  0  0  0  0  0  0  0  0  0  0  0  0  0  0  16
14 0  39 0  0  0  0  0  0  0  0  0  0  0  0  0  0  0  0  0  0  0  0  0  0  30 0  0  0  0  0  39 0  0  0  0  0  0  0  0  0  0  21 0  0  0  16
14 0  27 31 41 0  0  0  0  0  0  0  0  0  0  0  0  0  31 0  0  0  0  0  0  0  0  0  0  0  0  0  32 0  0  0  0  0  0  31 0  0  0  0  0  0  16
14 2  2  2  2  2  3  0  0  0  0  0  0  0  0  28 0  1  2  3  0  0  0  0  0  0  0  0  0  0  0  4  5  6  0  0  0  0  0  4  6  0  0  39 0  0  16
14 37 37 37 37 37 36 0  0  0  0  0  30 4  5  5  5  9  9  38 0  0  0  0  31 31 0  41 0  0  0  0  0  0  0  0  0  0  0  0  0  0  0  0  0  0  16
14 0  0  0  0  0  0  0  0  21 0  0  0  0  0  0  0  22 9  38 0  0  0  4  5  5  5  6  0  0  0  0  0  0  0  0  0  28 41 0  0  0  0  21 0  0  16
14 0  0  0  0  0  0  0  0  0  0  0  0  0  0  39 0  22 9  38 0  0  0  0  0  0  0  0  0  0  0  0  0  0  0  0  4  5  5  5  6  0  0  0  0  0  16
14 0  0  0  0  0  0  0  0  0  28 0  24 0  42 0  0  22 9  38 0  0  0  0  0  0  0  0  0  0  21 0  0  21 0  0  0  0  0  0  0  73 0  0  0  0  16
14 2  2  2  2  3  0  0  0  4  5  5  23 2  2  2  2  2  2  2  3  0  0  0  0  0  0  0  0  0  0  0  0  0  0  0  0  0  0  0  0  4  5  5  6  0  16
14 9  9  9  9  38 7  7  7  7  7  7  22 9  9  9  9  9  9  9  38 7  7  7  7  7  7  7  7  7  7  7  7  7  7  7  7  7  7  7  7  7  7  7  7  7  16
14 9  9  9  9  38 10 10 10 10 10 10 22 9  9  9  9  9  9  9  38 10 10 10 10 10 10 10 10 10 10 10 10 10 10 10 10 10 10 10 10 10 10 10 10 10 16
17 18 18 18 18 18 18 18 18 18 18 18 18 18 18 18 18 18 18 18 18 18 18 18 18 18 18 18 18 18 18 18 18 18 18 18 18 18 18 18 18 18 18 18 18 18 19

