21 47
11 12 12 12 12 12 12 12 12 12 12 12 12 12 12 12 12 12 12 12 12 12 12 12 12 12 12 12 12 12 12 12 12 12 12 12 12 12 12 12 12 12 12 12 12 12 13
14 18 18 18 18 18 18 18 18 18 18 18 18 18 18 18 18 18 18 18 18 18 18 18 18 18 18 18 18 18 18 18 18 18 18 18 18 18 18 18 18 18 18 18 18 18 16
14 0  0  0  0  0  0  0  0  0  0  0  0  0  0  0  0  0  0  0  0  0  0  0  0  0  0  0  0  0  0  0  0  0  0  0  0  0  0  0  0  0  0  0  0  0  16
14 40 0  0  0  0  0  0  0  0  0  0  0  0  0  0  0  41 0  0  0  39 0  63 0  0  0  0  0  0  0  0  0  0  0  0  0  0  0  0  0  0  0  0  0  0  16
14 63 0  42 0  0  0  0  0  0  0  0  0  0  0  44 45 45 45 45 45 45 45 48 0  0  0  0  0  0  0  0  0  0  0  0  0  60 61 61 62 0  0  0  0  0  16
14 45 45 45 45 48 0  0  0  0  0  0  0  0  0  46 50 50 50 50 50 50 50 52 0  0  71 0  0  0  0  0  0  0  0  0  0  0  0  0  0  0  0  71 0  0  16
14 50 50 50 50 51 48 0  0  0  0  0  0  0  0  56 47 47 47 47 47 47 47 57 0  0  0  0  0  0  0  0  0  0  0  0  0  0  0  0  0  0  0  0  72 0  16
14 50 50 50 50 50 51 48 0  0  70 39 0  0  0  0  0  0  0  0  0  0  0  0  0  0  0  60 61 62 0  0  0  0  69 0  0  0  0  0  0  44 45 45 45 45 16
14 47 47 47 47 47 47 57 0  0  60 62 0  0  0  0  0  0  0  0  0  0  0  0  0  0  0  0  0  0  0  0  44 45 45 45 45 48 0  0  0  46 50 50 50 50 16
14 0  0  0  0  0  0  0  0  0  0  0  0  0  0  0  68 0  0  0  0  0  0  60 62 0  0  0  0  0  0  0  46 50 50 50 50 51 48 0  0  56 47 47 47 47 16
14 0  0  0  0  0  0  0  0  0  0  0  0  0  0  60 61 61 61 62 0  0  0  0  0  0  0  0  0  42 0  0  46 50 50 50 50 50 52 0  0  0  0  0  0  39 16
14 0  0  0  0  0  0  0  0  60 62 0  0  0  0  0  0  0  0  0  0  0  0  0  0  0  44 45 45 45 45 45 54 50 50 50 50 50 51 48 0  0  43 0  0  0  16
14 0  0  0  0  0  0  0  0  0  0  0  0  0  0  0  0  0  0  0  0  0  0  0  0  0  56 47 47 47 47 47 47 47 47 47 47 47 47 51 61 61 61 61 61 61 16
14 0  65 0  64 0  0  0  0  0  0  0  60 61 61 62 0  0  0  67 0  0  0  0  0  0  0  0  0  0  0  0  0  0  0  0  0  0  0  0  0  0  39 0  0  0  16
14 0  0  63 0  0  0  0  0  0  0  0  0  0  0  0  0  0  44 45 45 45 48 0  0  0  0  0  0  0  0  0  0  0  0  0  0  0  0  0  0  0  41 0  0  0  16
14 45 45 45 45 45 45 45 48 0  0  0  0  0  0  0  0  0  46 50 50 50 52 0  0  0  0  0  0  0  66 0  0  0  0  71 0  0  0  0  0  60 61 62 0  0  16
14 50 50 50 50 50 50 50 52 68 0  0  0  0  0  0  39 0  46 50 50 50 52 0  71 70 0 0  44 45 45 48  0  0  0  0  0  0  71 0  0  0  0  0  0  0  16
14 50 50 50 50 50 50 50 51 55 45 48 59 59 59 59 44 45 45 45 45 45 45 45 45 45 45 53 54 50 50 52 59 59 59 59 59 59 59 59 59 59 59 59 59 59 16
14 50 50 50 50 50 50 50 50 50 50 52 58 58 58 58 46 50 50 50 50 50 50 50 50 50 50 50 50 50 50 52 58 58 58 58 58 58 58 58 58 58 58 58 58 58 16
14 50 50 50 50 50 50 50 50 50 50 52 58 58 58 58 46 50 50 50 50 50 50 50 50 50 50 50 50 50 50 52 58 58 58 58 58 58 58 58 58 58 58 58 58 58 16
17 18 18 18 18 18 18 18 18 18 18 18 18 18 18 18 18 18 18 18 18 18 18 18 18 18 18 18 18 18 18 18 18 18 18 18 18 18 18 18 18 18 18 18 18 18 19

